21;15;6;
#####################
#         #         #
#         #    F    #
#         #    F    #
#         #    F    #
#         #    F    #
#         #    F    #
#         # F  F  F #
#        B#  F F F  #
#        B#   FFF   #
#        B#    F    #
#####    B#         #
# A WFF  BW    E    #
#   #WF  B*         #
#####################