21;15;6;
#####################
#         #         #
#         #    F    #
#         #    F    #
#         #    F    #
#         #    F    #
#         #    F    #
#        W# F  F  F #
#        B#  F F F  #
#        B#   FFF   #
#        B#    F    #
#WWWWWWWWB#         #
#        BW    E    #
#  A     B*         #
#####################