6;
####################
#        #         #
#        #    F    #
#        #    F    #
#        #    F    #
#        #    F    #
#        # F  F  F #
#       B#  F F F  #
#       B#   FFF   #
#       B#    F    #
#       B#         #
#       BW    E    #
# A     B*         #
####################