24;15;6;
########################
#            #         #
#            #    F    #
#            #    F    #
#            #    F    #
#            #    F    #
#######      #    F    #
#   #WWF     # F  F  F #
#   #W#F    B#  F F F  #
#   #W#F    B#   FFF   #
#     #F    B#    F    #
#   # #F    B#         #
# A #F#FF   BW    E    #
#   #F#WF   B*         #
########################