24;16;34;
########################
#W#                 #FW#
#B#     A           #B*#
#B#                    #
#B#     B         BW F #
#       B         BW F #
###     B         BW F #
#       B         BW F #
#       B         BW F #
#       B         BW F #
#       B         B*FF*#
#       BW         FF**#
#       B*        BF***#
#######WB*         F####
#BBBBBBBB*    BBBBFFFFE#
########################