24;15;20;
########################
#               #W#    #
#  A              #    #
#               #B#    #
#      W        #B#    #
#     BW        #B#    #
#     BW        #B#    #
#     BW        #B#    #
#     BW        #B#    #
#     BW        #B#    #
#     BW        #B######
#     BW        #B     #
#     BW        #B  E  #
#    #BW        #B     #
########################